[console_scripts]
update-cfgm-config = contrail_provisioning.config.setup:fix_cfgm_config_files
upgrade-vnc-database = contrail_provisioning.database.upgrade:main
remove-cassandra-node = contrail_provisioning.database.setup:remove_cassandra_node
reset-vnc-database = contrail_provisioning.database.reset:main
restart-zoo-server = contrail_provisioning.database.setup:restart_zookeeper_server
upgrade-vnc-collector = contrail_provisioning.collector.upgrade:main
migrate-vnc-database = contrail_provisioning.database.migrate:main
setup-vnc-collector = contrail_provisioning.collector.setup:main
remove-galera-node = contrail_provisioning.openstack.ha.galera_setup:remove_galera_node
setup-vcenter-plugin = contrail_provisioning.vcenter_plugin.setup:main
setup-vnc-openstack = contrail_provisioning.openstack.setup:main
update-zoo-servers = contrail_provisioning.database.setup:update_zookeeper_servers
setup-vnc-galera = contrail_provisioning.openstack.ha.galera_setup:main
upgrade-vnc-compute = contrail_provisioning.compute.upgrade:main
compute-live-migration-setup = contrail_provisioning.storage.compute.livemigration:main
setup-vnc-amqp = contrail_provisioning.common.amqp_setup:main
setup-vnc-livemigration = contrail_provisioning.storage.livemigration_setup:main
decommission-cassandra-node = contrail_provisioning.database.setup:decommission_cassandra_node
readjust-cassandra-seed-list = contrail_provisioning.database.setup:readjust_seed_list
setup-vnc-database = contrail_provisioning.database.setup:main
upgrade-vnc-openstack = contrail_provisioning.openstack.upgrade:main
setup-vnc-compute = contrail_provisioning.compute.setup:main
livemnfs-setup = contrail_provisioning.storage.storagefs.livemnfs_setup:main
add-mysql-perm = contrail_provisioning.openstack.ha.galera_setup:add_mysql_perm
setup-vnc-tor-agent = contrail_provisioning.compute.toragent.setup:main
setup-vnc-webui = contrail_provisioning.webui.setup:main
setup-vnc-interfaces = contrail_provisioning.common.interface_setup:main
setup-quantum-in-keystone = contrail_provisioning.config.quantum_in_keystone_setup:main
update-webui-config = contrail_provisioning.webui.setup:fix_webui_config
setup-vnc-storage = contrail_provisioning.storage.setup:main
setup-vnc-storage-webui = contrail_provisioning.storage.webui_setup:main
upgrade-vnc-webui = contrail_provisioning.webui.upgrade:main
upgrade-vnc-control = contrail_provisioning.control.upgrade:main
setup-vnc-keepalived = contrail_provisioning.common.keepalived_setup:main
storage-fs-setup = contrail_provisioning.storage.storagefs.setup:main
add-galera-config = contrail_provisioning.openstack.ha.galera_setup:add_galera_cluster_config
unregister-openstack-services = contrail_provisioning.openstack.setup:service_unregister
setup-vnc-config = contrail_provisioning.config.setup:main
setup-vnc-static-routes = contrail_provisioning.common.staticroute_setup:main
update-collector-config = contrail_provisioning.collector.setup:fix_collector_config
upgrade-vnc-config = contrail_provisioning.config.upgrade:main
storage-webui-setup = contrail_provisioning.storage.webui.setup:main
setup-vnc-control = contrail_provisioning.control.setup:main

